hours_Monday	string
hours_Thursday	string
hours_Friday	string
hours_Wednesday	string
hours_Tuesday	string
hours_Saturday	string
address 	string
city	string
is_open	int
latitude	double
review_count	int
stars	double
name	string
attributes_BikeParking	string
attributes_BusinessAcceptsCreditCards	string
attributes_RestaurantsDelivery	string
attributes_BusinessParking_garage	string
attributes_BusinessParking_street	string
attributes_BusinessParking_validated	string
attributes_BusinessParking_lot	string
attributes_BusinessParking_valet 	string
attributes_NoiseLevel	string
attributes_RestaurantsGoodForGroups	string
attributes_RestaurantsPriceRange2	int
attributes_RestaurantsReservations	string
attributes_RestaurantsTakeOut	string
attributes_GoodForKids	string
attributes_RestaurantsAttire	string
attributes_HasTV	string
attributes_OutdoorSeating	string
neighborhood	string
state	string
categories	string
postal_code	string
business_id 	string
longitude	double
hours_Sunday	string
attributes_RestaurantsTableService	string
attributes_Alcohol	string
attributes_WheelchairAccessible	string
attributes_Caters 	string
attributes_WiFi	string
attributes_GoodForMeal_dessert	string
attributes_GoodForMeal_latenight	string
attributes_GoodForMeal_lunch	string
attributes_GoodForMeal_dinner	string
attributes_GoodForMeal_breakfast	string
attributes_GoodForMeal_brunch	string
attributes_Ambience_romantic	string
attributes_Ambience_intimate	string
attributes_Ambience_classy	string
attributes_Ambience_hipster	string
attributes_Ambience_touristy	string
attributes_Ambience_trendy	string
attributes_Ambience_upscale	string
attributes_Ambience_casual	string
hours 	string
attributes_Ambience_divey	string
