compliment_more	int
compliment_writer	int
compliment_funny	int
average_stars	double
cool 	int
review_count	int
compliment_plain	int
friends	string
compliment_note	int
fans	int
elite	string
compliment_profile	int
user_id	string
yelping_since	string
compliment_hot 	int
name	string
compliment_photos	int
compliment_cool	int
compliment_list	int
compliment_cute	int
useful	int
funny 	int